SCIENCE: la science (en general)
A SCIENTIST: un scientifique
SCIENTIFIC KNOWLEDGE: connaissances scientifiques
A LABORATORY/ A LAB: un laboratoire
A RESEARCH INSTITUTE: centre de recherche
Ø RESEARCH: la recherche, des recherches 
A RESEARCHER: un chercheur
A MATHEMATICIAN: un mathématicien 
MATHEMATICs: les maths
A PHYSICIST (!= physician): un physicien (!= un médecin)
PHYSICS: la physique
A CHEMISTS : un Ghimiste 
CHEMISTRY: la chimie
A CHEMICAL: un produit chimique
TO FUND RESEARCH: financer la recherche
PUBLIC/ PRIVATE FUNDING: le financement public / privé 
TO CUT A BUDGET: réduire un budget
A SUBSIDY: une subvention
TO STUDY STH: étudier qch
A PHENOMENON (PL PHENOMENA): un phénomène
TO PROVE (TO DISPROVE A THEORY): prouver (réfuter une théorie)
TO PUT FORWARD / BUILD A THEORY: émettre une théorie
TO DEVELOP: mettre au point
TO SOLVE A PROBLEM: résoudre un problème 
TO ANALYSE: analyser
A FIELD OF RESEARCH: un domaine de recherche
TO DO/ CARRY OUT RESEARCH IN: faire de la recherche en 
TO CARRY OUT EXPERIMENTS: mener des experiences
A GUINEA PIG: un Cobaye / un cochon d’Inde
A SAMPLE: un échantillon
A DISCOVERY, A FINDING: une découverte
TO MAKE A MISTAKE: faire une erreur
TO MAKE PROGRESS: faire des progrès
AN ADVANCE < A BREAKTHROUGH: un progrès < un progrès décisif
A SURGE IN DRONE USE: augmentation sensible de l'utilisation de drones
TO BE A GAME-CHANGER: être qch qui change la donne 
REMOTE-CONTROLLED AIRCRAFT: engins aériens télécommandés 
TO CLUTTER AIRSPACE: encombrer l'espace aérien
DRONE LAWS: la legislation sur les drones 
SPACE DEBRIS / JUNK: debris spatiaux 
THE GRAVEYARD ORBIT: 1’orbite cimetière 
TO CRASH (INTO STH): s écraser (sur qch)
THE AEROSPACE INDUSTRY: l'industrie aérospatiale 
SPACE EXPLORATION: l'exploration spatiale
THE EUROPEAN SPACE AGENCY (ESA): l'agence spatiale européenne 
NASA: la NASA
OUTER SPACE: l'espace
A SPACE TELESCOPE: un telescope spatial 
AN OBSERVATORY: un observatoire
A SPACE BUFF: un fana de l'espace
THE ISS: la Station spatiale internationale
A SPACE FARING NATION: une puissance spatiale 
THE CREW: l'équipage
TO HAND PICK A TEAM: sélectionner soigneusement une équipe 
AN ASTRONAUT: un astronaute
A SPACECRAFT: un engin spatial 
A SPACESHIP : vaisseau spatial (habité)
MANNED / UNMANNED: habité / inhabité 
A SPACE SHUTTLE: une navette 
REUSABLE: réutilisable
TO FLY A ROCKET: faire voler une fusée
TO TRAVEL TO SPACE: voyager dans l’espace 
A SPACE PROBE: une sonde spatiale
A ROVING ROBOT/ A ROVER: un robot d'exploration autonome
A COMMUNICATIONS SATELLITE: un satellite de télécommunica° 
REMOTE-CONTROLLED: télécommandé
TO TRANSMIT WEATHER FORECASTS: transmettre des prévisions météo
WEIGHTLESSNESs: l’apesanteur
TO SPACEWALK: faire une sortie dans l’espace
SPACE TOURISM: le tourisme spatial 
AN ASTEROID: un astéroide
UNIDENTIFIED FLYING OBJECTS (UFOS): des ovnis
EXTRA-TERRESTRIAL LIFE FORMS: formes de vie extraterrestre
A LAUNCH PAD: une aire de lancement
TO COUNT DOWN: lancer le compte à rebours
TO TAKE OFF: décoller 
TO DOCK WITH = TO UNDOCK : S’arrimer à !=  désamarrer
TO COLLIDE WITH: entrer en collision avec
TO DISINTEGRATE: se désintégrer
TO CRASH-LAND: faire un atterrissage force 
A TOUCHDOWN: un atterrissage
TO CIRCLE THE EARTH: tourner autour de la terre
TO ORBIT A SATELLITE: placer un satellite en orbite 
TO SAMPLE THE SOIL: prélever des échantillons du sol
TO MAP THE SURFACE OF A PANET: cartographier la surface d’une planète
FUTURISTIC: futuriste
