TO MEET ENERGY NEEDS/REQUIREMENTS: répondre aux besoins en énergie 
AN (INTERMITTENT) ENERGY SOURCE : une énergie (intermittente) 
THE ENERGY GAP /SHORTFALL/SHORTAGE : la pénurie d’énergie
TO DRAW ENERGY FROM (A SOURCE): tirer de l’énergie de
TO YIELD (ENERGY) : produire (de l’énergie)
TO SUPPLY (ENERGY): fournir
UTILITIES/ UTILITY COMPANIES' compagnies des eaux, électricité ou gaz
A POWER GRID : réseau de distribution d’électricité
A POWER STATION (UK)/ PLANT (us): une centrale électrique
A SMART METRE: un compteur intelligent 
THE ENERGY MIX : le mix énergétique
ENERGY DEPENDENCE : la dépendance énergétique 
TO WASTE (ENERGY): gaspiller (l’énergie)
TO EXHAUST SUPPLIEs: épuiser des réserves
TO CURB ENERGY CONSUMPTION: restreindre la consommation d’énergie
FOSSIL FUELS: les énergies fossiles, non renouvelables
TO DEPLETE: (réserves) se réduire
TO RUN OUT OF STH : manquer progressivement de qch
A SHORTAGE: une pénurie
SCARCE: rare 
SCARCITY : rareté
COAL: le charbon 
COAL-MINING: l’exploitation minière
A COAL POWER STATION : une centrale thermique
(CRUDE) OIL ([!] PETROL): le pétrole (brut) ( [!] essence)
OFFSHORE DRILLING: le forage en mer
AN OIL RIG: une plateforme de forage
AN OIL REFINERY: une raffinerie
AN OIL COMPANY: une compagnie pétrolière
TO DRILL (FOR): forer (pour trouver qch)
NATUREL GAS: le gaz naturel
A GASWORKS: une usine à gaz
SHALE GAS: gaz de schiste 
FRACKING: fracturation hydraulique
NUCLEAR POWER: l’énergie nucléaire
A NUCLEAR POWER STATION (UK)/ PLANT (US): centrale nucléaire 
REPROCESSING (NUCLEAR WASTE): le retraitement des déchets 
NUCLEAR WASTE DISPOSAL: traitement des déchets radioactifs 
TO PHASE OUT NUCLEAR POWER: réduire progressivement le nucléaire
TO SHUTTER /CLOSE DOWN A POWER STATION: fermer une centrale
RENEWABLES / RENEWABLE ENERGY : énergies renouvelables
INEXHAUSTIBLE (EXHAUSTIBLE) : inépuisable 
SOLAR POWER: l’énergie solaire 
SOLAR PANELS: panneaux solaires 
WIND POWER: l’énergie éolienne
A WIND FARM: parc éolien 
A WINDMILL: une éolienne
HYDROELECTRIC POWER: l’énergie hydroélectrique 
TIDAL POWER: l’énergie marémotrice
A TIDAL BARRAGE: un barrage
TO STORE (ENERGY): stocker (de l’énergie)
TO SAVE/CONSERVE (ENERGY): économiser (l’énergie)
TO SWITCH FROM ... TO... : passer de...à...
TO BE IN LIMITED SUPPLY: constituer une ressource limitée
PLENTIFUL: abondant
RÉGULATIONS: la règlementation
AN ENERGY-SAVING CAMPAIGN / ENERGY-SAVING MEASURE: campagne / mesure en faveur des économies d’énergie
ENERGY EFFICIENCY : efficacité énergétique
ENERGY-EFFICIENT : économique en énergie
ENERGY-INTENSIVE : gourmand en énergie
CARMAKERS: les fabricants automobiles
TO RUN ON (PETROL): rouler à (l’essence)
FUEL CONSUMPTION: la consommation d’essence
TO CONSUME /BURN (PETROL): consommer (de l’essence)
A GREEN CAR: une voiture non polluante 
PETROL (UK) / GAS (US): del’essence 
DIESEL (FUEL): du gasoil
HYDROGEN : l’hydrogène
FUEL CELLS: les piles à combustible
TO CHARGE A BATTERY: recharger une batterie
AN EV CHARGING STATION: une borne de recharge pour Voitures électriques
TO HAVE A 100-MILE RANGE: avoir une autonomie de 100 miles
TO PLUG INTO AN ELECTRIC OUTLET: se brancher sur une prise électrique
BIOFUEL: un biocarburant	
RAPESEED: graine de colza
SUGAR BEET: betterave à sucre 
sUGAR CANE: canne à sucre
METHANOL: méthanol
A METHANOL-POWERED CAR: voiture qui roule au l3etro l3ol
A LORRY (UK) / A TRUCK (US): un camion
TO BE/TRAVEL/GET AROUND ON FOOT: être à pieds
TO TRAVEL BY CAR/ TRAIN / PLANE: voyager en voiture/ avion/ train
ROAD TRAFFIC: la circulation routière
TRAFFIC FLOW:circulation
CONGESTED ROADS: routes embouteillées
TRAFFIC JAMS: embouteillages
ROAD PRICING: péages routiers
A CONGESTION CHARGE: taxe embouteillage, péage urbain
A CAR-POOLING LANE: file réservée au covoiturage
PARK AND RIDE: parc relais
TO CUT TRAFFIC BY ...%: réduire la circulation de ...%
DRINK-DRIVING /DRUNK(EN) DRIVING: conduite en état d’ébriété
ROAD SAFETY: sécurité routière
TO COMMUTE (FROM/TO): faire le trajet domicile-travail (entre/et)
PUBLIC TRANSPORT: transports en commun
A CAR/BICYLE-SHARING SCHEME: syst. d’auto-partage/vélos en libre-service
AN ANTIQUATED NETWORK: un réseau vétuste
THE UNDERGROUND  (UK) / THE SUBWAY (US): le métro
A TAXI (UK) / A CAB (US): un taxi
A RAILROAD: ligne de chemin de fer
A SINGLE / RETURN TICKET: un aller simple / aller-retour 
TO BE DELAYED: avoir du retard
TO CATCH/MISS A TRAIN: attraper/manquer un train
TO BE PACKED / OVERCROWDED: être bondé
AN AIRLINER: avion de ligne 
THE CREW: l’équipage
A PLANE DISASTER: Catastrophe aérienne
THE AIRCRAFT INDUSTRY: l’industrie aéronautique
A BUDGET AIRLINE: une compagnie à bas coût 
AIR TRAFFIC: La circulation aérienne
AN AIRPORT: un aéroport
TO FLY(FLEW, FLOWN) : prendre l’avion, voyager en avion
TO TAKE OFF: décoller (pour un avion)
TO LAND : atterrir (pour un avion)
A DROUGHT/FAMINE-STRICKEN AREA: zone frappée par la sécheresse/la famine
A FLOOD-RISK AREA : zone inondable
THE WORST-HIT AREA: la zone la plus durement frappée
A HURRICANE/DROUGHT PRONE AREA: zone sujette aux ouragans/sécheresses...

