ADVERTISING: la publicité (en général)
AN ADVERTISEMENT: une publicité (écrite)
AN ADVERTISING AGENCY: une agence de publicité
AN ADVERTISER: un annonceur
A MARKET SURVEY: une enquête de marché 
A POLL: un sondage
HARD-SELL ADVERTISING: la publicité agressive 
DECEPTIVE ADVERTISING: la publicité mensongère 
A COMMERCIAL: une publicité (à la télé)
A COMMERCIAL BREAK: une coupure pub
A SIGN: enseigne
A POSTER, A BILL: une affiche
A POP-UP AD / A POP-UP: fenêtre intruse (ou fenêtre surgissante)
A WEB BANNER / A BANNER AD: bannière publicitaire
PRODUCT ENDORSEMENT: promotion de produits (par des célébrités)
A BRAND: une marque (de produit) 
BRAND IMAGE : image de marque
FAME / RECOGNITIoN: notoriété
TO TARGET CUSTOMERS: cibler la clientèle 
COMMUNICATION POLICY: politique de communication 
TO PITCH: promouvoir
ADVERTISING PRESSURE: pression publicitaire
A CHILD’S PESTER POWER: le pouvoir influençateur des enfants envers leurs parents (pour acheter qch, avoir ce qu’ils veulent..)
THE LAW OF SUPPLY AND DEMAND: loi de l’offre et de la demande
A DEPARTMENT STORE: un grand magasin
A SHOPPING CENTRE/ A MALL (Us): un centre commercial
A SHOP / A STORE (Us): un magasin
A SALES ASSISTANT: un vendeur
A CAR DEALER: un concessionnaire (de voitures) 
CONSUMPTION: la consommation
A CONSUMER: un consommateur 
TO CONSUME: consommer
THE CONSUMER SOCIETY: la société de consommation
CONSUMER GOODS: les biens de consommation
CONSUMER RIGHTs: les droits des consommateurs
CONSUMER HABITs: les habitudes de consommation
CONSUMER NEEDS / CONSUMER DEMAND: besoins/demandes des consorrimateurs
A CONSUMER GROUP/ CONSUMER ORGANISATION: une association de consommateurs
A STAPLE: denrée de base
TO DO ONE'S SHOPPING, TO GO SHOPPING: faire les courses
A PRICE-CONSCIOUS CONSUMER: consommateur très attentif aux prix
TO BE THRIFTY: être économe
TO BE A SPENDTHRIFT: être dépensier
TO BE STINGY: être économe / avare
SB’S EXPECTATIONS / REQUIREMENTS: attentes de qn
PURCHASING POWER: le pouvoir d'achat
TO CURB CONSUMPTION: freiner la consommation
THE BARE NECESSITIES: le stricte nécessaire
TO LOSE BUSINESS: perdre des clients / du chiffre
TO DEVELOP CUSTOMER LOYALTY: fidéliser la clientèle 
TO LINE SB’S POCKETs: remplir les poches de qn (argent) 
A FAD: phénomène de mode, mode passagère
A PASSING (# LASTING) TREND: une tendance passagère (#durable)
A CRAZE: engouement, frénésie
A SALE: une vente 
(BARGAIN) SALES: les soldes
PRICING TACTICS: les politiques tarifaires 
DECEITFUL: trompeur, déloyal 
FAiR: juste
TO RIP OFF CUSTOMERS: arnaquer les clients
A CONSUMER WATCHDOG GROUP: association de défense des consommateurs
TO ORDER STH (ONLINE): commander qch (en ligne)
TO SPEND TIME/MONEY ON SB/STH: consacrer du temps/ de l’argent à
TO SELL STH TO SB: vendre qch à qn
TO BUY STH FROM SB, TO PURCHASE: acheter qch (à qn) 
TO PAY $10 FOR STH: payer qch 10 dollars
A CREDIT CAno: une carte bancaire
A COIN: pièce de monnaie
A BANKNOTE: un billet
TO PAY CASH: payer en espèces
TO PAY ON CREDIT: payer à crédit
TO TIP SB: donner un pourboire à qn
TO CHANGE MONEY: changer de l'argent 
THE EXCHANGE RATE: le taux de change
A RANGE OF PRODUCTs: une gamme de produits 
A COMMODITY: une denrée
AN ITEM: un article
A PRICE TAG: une étiquette de prix
A LABEL: une étiquette (descriptive)
THE CONTENTS: le contenu, la composition 
EXPENSIVE, COSTLY/ PRICEY: cher, coûteux 
ECONOMIC: économique (=lié à 1 économie)
ECONOMICAL, COST-SAVING: économique (= pas cher, fait faire des économies)
CHEAP, INEXPENSIVE: bon marché 
DIRT CHEAP: à très bas prix
SHODDY: de mauvaise qualité
TO LAUNCH STH: lancer qch sur le marché 
TO MARKET STH: commercialiser qch
HARMFUL: nocif
UNSAFE: dangereux 
TAINTED: avarié, contaminé
TO PASS STH OFF AS: faire passer qch pour 
DEFECTIVE, FAULTY: défectueux 
OBSOLETE: Obsolète
DISPOSABLE/ RECYCLABLE: jetable / recyclable
A CHEMICAL ADDITIVE: un additif chimique 
PESTICIDES: les pesticides
FERTILISERS: les engrais 
PRESERVATIVES: conservateurs
GM FOOD: les aliments oct 
ORGANIC FOOD: la nourriture bio
TO COMPLAIN ABOUT STH: se plaindre de qch 
TO RETURN AN ITEM: rendre (un article)
TO GET A REFUND: obtenir un remboursement
AFTER-SALES SERVICE: service après-vente
TO TAKE A PRODUCT OFF THE MARKET/ THE SHELVES: retirer un produit du marché / des rayons 
TO THROW STH AWAY: jeter qch 
SECOND HAND (ADJ): d'occasion
(A) HAND-ME-DOWN (ADJ/N): vêtement/objet de seconde main
