THE STAFF : le personnel
THE HIRING PROCESS : le processus de recrutement
A NAME-BLIND JOB APPLICATION: un CV anonyme
CORPORATE CULTURE : culture d’entreprise
TO HAVE A DRESS CODE: avoir un code vestimentaire
DRESS DOWN FRIDAY/CASUAL FRIDAY: (port d'une tenue décontractée le vendredi au travail)
TO OWN / RUN A BUSINESS: posséder / diriger une entreprise 
TO BE SELF-EMPLOYED: être à son compte
BOGUS SELF-EMPLOYMENT: auto-entreprenariat fictif
A FAKE JOBS SCANDAL: un scandale autour d’emplois fictifs 
AN EMPLOYER (an employee): un employeur (un employé)
A TRAINEE / AN INTERN: un stagiaire
A SKILLED WORKER: un ouvrier qualifié (Jw UNSKILLED WORKER)
A WHITE-COLLAR WORKER: un employé de bureau
A BLUE-COLLAR WORKER: un ouvrier
A CIVIL SERVANT / STATE EMPLOYEE: un fonctionnaire
A TECHNICIAN: un technicien
A MECHANIC: un mécanicien
AN EXECUTIVE: un cadre
AN ENGINEER: un ingénieur
THE LABOUR MARKET: le marché du travail
THE WORKING POPULATION: la population active
TO APPLY FOR A JOB (an application): postuler pour un emplOi 
A JOB CENTER: une agence pôle emploi
A JOB SEEKER: un demandeur d’emploi
THE UNEMPLOYED / THE JOBLESS: les chômeurs
HIGH / LOW UNEMPLOYMENT (AMONG): Ghômage élevé /faible (chez) 
TO BE ENTITLED TO STH: avoir droit à qqch
UNEMPLOYMENT BENEFITS: allocation chômage
TO BE ON THE DOLE (UK): toucher le chômage
A CAREER: une carrière
SB’S CALLING: la vocation de qn
JOB PROSPECTS: des débouchés professionnels
TO HAVE THE RIGHT SKILL SET (FOR): avoir les compétences requises
A HEAD-HUNTER: un chasseur de têtes
TO TAP A TALENT POOL: exploiter un réservoir de compétence/talent
TO EMPLOY SB AS A...: employer qn comme....
TO TAKE ON / TO HIRE SB (As) : embaucher (comme) 
THE PUBLIC / PRIVATE SECTOR: le secteur public / privé 
COMPETITION: la concurrence
TO COMPETE WITH sB: être en concurrence avec (qn)
WORK EXPERIENCE: une expérience professionnelle 
TO RETRAIN: se reconvertir
SUNDAY TRADING: le travail dominical 
WORKING HOURS /TIME: le temps de travail
A NINE-TO-FIVE JOB: un emploi à horaires de bureau
A 35-HOUR WORKING WEEK : une semaine de 35 heures 
TO WORK OVERTIME: faire des heures supplémentaires 
A WORKAHOLIc: un bourreau de travail
FULL-TIME/ PART-TIME: à temps plein/ à temps partiel 
TO TAKE A DAY OFF: prendre un jour de congé
A BANK HOLIDAY / A HOLIDAY (Us): un jour férié
TO BE ON SICK LEAVE / TO BE OFF SICK (INF.): ê en arrêt de travail 
TO BE ON MATERNITY/PATERNITY LEAVE: ê en congé maternité/paternité 
TO RETIRE: partir en retraite
AN OLD AGE PENSIONER / RETIRÉE [US]: un retraitée
TO RAISE THE RETIREMENT/PENSION AGE: repousser l’âge de départ à la retraite
INDUSTRIAL RELATIONS: rappOrtS humains dans l'entreprise 
AN INDUSTRIAL DISPUTE: un conflit social
DISGRUNTLED EMPLOYEES: employés mécontents 
TO WALK OUT / TO GO ON STRIKE: se mettre en grève 
A STRIKER: un gréviste
TO DEMONSTRATE: manifester (dans les rues) 
A PLACARD: une pancarte
A (TRADE) UNION (a trade unionist): un Syndicat (un syndicaliste)
TO RESUME WORK: reprendre le travail
AN INDUSTRIAL ACCIDENT: accident du travail 
TO CLAIM LIVES: faire des victimes (décès) 
CASUALTIES: victimes (morts ou blessés)
TO BE FIT TO WORK: être apte au travail 
A SALARY GAP: un écart de salaire
THE GENDER PAY GAP: différences de salaire entre les sexes
THE GLASS CEILING (TO SHATTER): le plafond de verre (briser) 
BARRIERS TO FEMALE ADVANCEMENT: obstacles à la promotion des femmes
TO JUGGLE A CAREER AND A FAMiLv: jongler pour concilier carrière et famille
WORK-FAMILY BALANCE: équilibre entre vie professionnelle et vie familiale 
TO BE DISCRIMINATED AGAINST: être victime de discrimination(s) 
TO DISCRIMINATE AGAINST SB:pratiquer une discrimination à l'encontre de
AFFIRMATIVE ACTION: la discrimination positive
TO INTRODUCE QUOTAS: instaurer des quotas
EQUAL OPPORTUNITY: l'égalité des chances
TO ACHIEVE EQUALITY WITH SB: atteindre l’égalité avec 
TO GET EQUAL PAY: obtenir un salaire égal
TO EMBRACE AI (!= to be reluctant): adopter (être réticent)
TO PUSH FOR AI FLUENCY: encourager la maîtrise de l’IA
TO BE A LUDDITE: ê réfractaire à la modernité/aux nouvelles techs.
VOLUNTEERING: le bénévolat (—›A VOLUNTEER un bénévole) 
ENTERPRISING : entreprenant
LABOUR / THE WORKFORCE : la main d’oeuvre 
TO EARN ONE'S LIVING: gagner sa vie
TO SCRAPE BY: à peine s en sortir
TO HAVE TROUBLE MAKING ENDS MEET :avoir du mal à joindre les 2 bouts
TO EARN A DECENT LIVING: gagner décemment sa vie
TO BE ON A COMPANY’S PAYROLL: être salarié d'une entreprise
PERFORMANCE-RELATED PAYS Salaire au rendement
A LIVING WAGE: Salaire permettant de vivre (décemment)
MINIMUM WAGE (the global minimum wage): le Smic (revenu de base universel)
SB'S SOCIAL STANDING: le niveau social de qn
A PAYRISE /A PAYRAISE [us]: une augmentation
TO CLIMB THE SOCIAL LADDER: prendre l’ascenseur social
TO CLIMB THE CORPORATE LADDER: gravir les échelons d'une entrep.
UPWARD MOBILITY (!= downward mobility): ascension sociale
A PAY FREEZE (a pay cut): le gel des salaires (une baisse de salaire) 
DOWNSIZING: le dégraissage (des effectifs)
TO LAY OFF: licencier en masse (raisons économiques)
TO MAKE SB REDUNDANT: licencier qn pour raisons écon.
REDUNDANCY: un licenciement (économique)
TO DISMISS: licencier
TO CUT JOBS: supprimer des emplois
TO AXE/SLASH JOBS: faire des coupes sombres dans la masse salariale
TO SACK / FIRE: mettre à la porte / renvoyer
TO RECEIVE A PINK SLIP (inf): recevoir une lettre de licenciement
A REWARDING JOB: un travail gratifidflt (JMENIAr: subalterne)
A THANKLESS JOB :  un travail ingrat
A BACK-BREAKING JOB : un emploi éreintant
A LOW-PAID JOB : un emploi mal payé (<	DERPAin : sous-payé) 
DEHUMANIZING : déshumanisant
TO MOONLIGHT/ WORK ON THE SLY (coll.): travailler au noir
A SWEATSHOP: atelier qui exploite les travailleurs
CHILD LABOUR : Ie travail des enfants
TO WORK FROM HOME: travailler chez soi 
WORK PLACEMENT: stage en entreprise 
IN THE WORKPLACE: sur le lieu de travail
TO APPOINT SB TO A POST: nommer qn à un poste
TO PROMOTE SB (!= to demote sb): promouvoir qn ( rétrograder qn)
A FIXED-TERM CONTRACT (!= an open-ended contract): un CDD (!=un CDI)

