THE FAMILY CELL: la cellule familiale
MARRIAGE!= a wedding: le mariage (institution)!= (la cérémonie)
A PARTNER: un compagnon
SAME-SEX MARRIAGE: le mariage homosexuel
TO DIVORCE SB (→ a divorcee): divorcer de qn (→  un divorce)
CHILD SUPPORT / ALIMONY (Us): pension alimentaire
A ONE-PARENT FAMILY: famille monoparentale
A TRANSGENDER MAN / WOMAN: un(e) transgenre
A SPOUSE: un conjoint/ une conjointe
A HUSBAND / A WIFE (pl. WIVES): un époux /une épouse
THE OFFSPRING / PROGENY: la progéniture
A SON, A DAUGHTER: fils , fille
A SIBLING: un frere ou une soeur (//A BROTHER / A SISTER)
CHILDHOOD: l'enfance (// A CHILD (PL CHILDREN)
AN ONLY CHILD: un enfant unique
KINSHIP: la parenté
TO BE RELATED: avoir un lien de parenté
A RELATIVE: un parent (membre de la famille) (!=PARENTS  =  les parents)
AN AUNT / an uncle: une tante / un oncle
A cousin: un(e) cousin(e)
IT RUNS IN THE FAMILY: c’est de famille
THE APPLE NEVER FALLS FAR FROM THE TREE / (HE-SHE IS) A CHIP OFF THE OLD BLOCK: tel pere, tel fils / les chats ne font pas des chiens
PARENTHOOD: maternité/ paternité / parentalité
PLANNED PARENTHOOD CLINIC /FAMILY PLANNING SERVICES : planning familial
TEENAGE PREGNANCY: la grossesse des adolescentes
TO TERMINATE A PREGNANCY: interrompre une grossesse
TO HAVE AN ABORTION: se faire avorter
TO GIVE A BABY UP FOR ADOPTION : remettre un bébé aux services de l'adoption
A PROLIFER: adversaire de l'avortement
A PRO-CHOICER: partisan du droit à l’avortement
PARENTAL AUTHORITY: l’autorité parentale
IT’S UP TO PARENTS TO +BV: c’est de la responsabihté des parents de +V
PARENTING : éducation (de ses enfants)
SB'S UPBRINGING: éducation (manière dont on a été élevé) 
HARSH (!= OVERINDULGENT) : dur, sévère (!= trop indulgent) 
A ROLE MODEL: un modèle, un exemple
TO SET A GOOD/BAD EXAMPLE (FOR SB): donerle bon/marais exemple à
PEER-Pressure: pression sociale (du groupe, des amis)
TO STICK TOGETHER: se serrer les coudes
THE GENERATION Gap : le conflit des générations
TO WIDEN THE GAP (BETWEEN): élargir le fossé (entre)
TO BRIDGE THE GAP (BETWEEN): combler le fossé (entre) 
TO GET ON WELL WITH SB: s'entendre bien avec
TO CLASH WITH SB: se heurter à
THE ELDER GENERATION: la génération précédente
TO BE UNDER AGE: être mineur //TO COME OF AGE =  atteindre la majorité 
TO GROW UP (CHILD): grandir (//GROWN-UPS: les adultes) 
ADULTOOD: l’âge adulte
OLD AGE: la vieillesse 
OLD PEOPLE /THE ELDERLY: les pers. âgées
SENIOR CITIZENS: les personnes du 3eme âge
TO GROW OLD / TO AGE: vieillir
TO RETIRE: prendre sa retraite
A(N OLD-AGE) PENSIONER / A RETIREE: un retraité
A NURSING / RETIREMENT HOME: une maison de retraite 
ROUND-THE-CLOCK CARE: soins 24h / 24
LIFE EXPECTANCY: espérance de vie
THE SCHOOL YEAR: l'année scolaire (//A School DAY = jour d’école)
A TERM: trimestre
A BREAK/ RECESS (US): une pause, récréation
A PUPIL (UK) : un élève (A STUDENT: un étudiant, un élève (Us))
A SCHOOLMATE: camarade de classe 
THE FACULTY: le corps enseignant
A TEACHER: professeur (dans le secondaire)
A PROFESSOR: professeur (d’université)
A NURSERY SCHOOL: école maternelle
A SECONDARY SCHOOL / JUNIOR HIGH SCHOOL (US): collège 
A SENIOR HIGH SCHOOL: lycée
A STATE-RUN SCHOOL (UK): école publique (gratuite)
A PUBLIC/ INDEPENDENT/ PRIVATE SCHOOL : école privée 
(TUITION) FEEs: les frais de scolarité A L’ANNEE!) 
FEE-PAYING = payant
A BOARDING SCHOOL: un internat, un pensionnat
THE TIMETABLE: l'emploi du temps
A CURRICULUM: programme (d'études)
BUSINESS-FRIENDLY (CURRICULUM) :  en phase avec le monde du travail
HANDS-ON /PRACTICAL TRAINING: formation pratique/apprentissage
A SUBJECT: une matière
ACADEMIC ACHIEVEMENT: la réussite scolaire
TO LEARN : (élève) apprendre 
TO TEACH SB STH : enseigner qch à qn
TO DO ONE'S HOMEWORK: faire ses devoirs 
TO ATTEND SCHOOL: suivre les cours
THE CLASS BULLY: la terreur de la classe
TO MISBEHAVE: mal se conduire, faire des bêtises
TO PLAY UP: faire des siennes
TO BE OUT OF LINE:	dépasser les bornes
UNRULY: indiscipliné
TO CHEAT IN A TEST: tricher à un test
TO PLAY TRUANT (un)/SKIP SCHOOL, CUT CLASS (es): sécher
ABSENTEEISM: l'absentéisme
TO GET/BE GIVEN DETENTION: avoir une retenue
TO EXPEL / KICK SB OUT: renvoyer
TO ACT AS A DETERRENT: exercer un effet de dissuasion
TO DETER SB FROM (DOING) STH: dissuader qn de qch
nb : BABY BOOMERS (45-65) / GENERATION X (65-80) / GENERATION Y THE MILLENIALS — THE DIGITAL NATIVES (80-95) / GENERATION Z (95-10) / GENERATION ALPHA (10-...)
YOUTH: la jeunesse (—›THE YOUNG / rien YOUNG PEOPLE= les jeunes) 
A YOUNGSTER: un jeune
A TEENAGER: un adolescent (—›TEENAGE YEARS= l’adolescence) 
TO PROVIDE FOR SB: subvenir aux besoins de qn
FAMILY ALLOWANCE, CHILD BENEFITS [UK]: allocations familiales
TO BE ON WELFARE: toucher des aides sociales
TO SPEND TIME ON STH / DOING STH: consacrer du temps à 
TO BRING UP, TO RAISE CHILDREN: élever (les enfants)
TO LOOK AFTER, TO TAKE CARE OF SB: veiller sur qn
TO SIT (FOR) / TO TAKE AN EXAM: passer un examen
TO PASS AN EXAM (WITH FLYING COLOURS): réussir un examen (brillamment)
TO LEARN BY HEART / BY ROTE: apprendre par cœur
LITERATE: qui sait lire et écrire
COMPUTER-LITERATE: initié à / bon en l’informatique
COMPUTER-SAVVY: câlé en informatique
TECH-SAVVY: calé / qui s y connaît en nouvelles technologies
A SKILL: une compétence (KILL SET= gamme/palette de compétences) 
TO BE PROFICIENT IN: être compétent en
THE SCHOOL-LEAVING AGE : l'âge de fin de scolarité obligatoire
TO GRADUATE : obtenir un diplôme (//A GRADUATE = un diplômé) 
THE GRADUATE PREMIUM: l’écart de salaire que qn de diplômé espère obtenir en faisant des études
TO FAIL AN EXAM: rater un examen
TO BE BELOW STANDS: ne pas être au niveau
AN AVERAGE STUDENT: un élève moyen
AN UNDERACHIEVER/ A LOW ACHIEVER : mauvais élève/en échec scolaire
A COMMUNITY COLLEGE (Us): établissement post-bac en deux ans, sans sélection et peu onéreux.
TO ENROL = REGISTER: s’insrire (ENROLMENT, REGISTRATION = inscription)
MOOCS (Massive Open Online Courses) : MOOCS
E-LEARNING: apprentissage en ligne
A GRANT: bourse d’étude (selon revenus)
A HIGH ACHIEVER < AN OVERACHIEVER :  un élève doué < Surdoué 
A SCHOALRSHIP: bourse d’étude (selon résultats)
A REPORT CARD: un bulletin 
MARKS / GRADES (US)): notes
TO REPEAT (A YEAR): redoubler
TO DROP OUT OF SCHOOL (UNIVERSITY. . .): arrêter les études
AN ENGINEERING SCHOOL: une école d’ingénieurs 
A UNIVERSITY (UK) / COLLEGE (Us): université
A FELLOWSHIP: une bourse de recherche
VOCATIONAL EDUCATION: l'enseignement professionnel
HANDS-ON EXPERIENcE: expérience pratique/ de terrain
TO LEARN THE TRICKS OF THE TRADE / THE ROPES: apprendre les ficelles du métier
