A NEWS OUTLET: un média d’information
THE MAINSTREAM MEDIA(s): les médias traditionnels
THE PRESS: la presse écrite
QUALITY PAPERS: la presse de qualité
THE GUTTER PRESS: la presse à scandales
THE CIRCULATION: le tirage
TO SUBSCRIBE / TAKE OUT A SUBSCRIPTION TO: s'abonner à
A NEWSSTAND: un kiosque à journaux
A NEWSAGENT: un marchand de journaux
AN EDITOR: un rédacteur en chef
A FREELANCER: un pigiste
A PRESS MOGUL / TYCOON: un magnat de la presse
A PIECE OF NEWs: une nouvelle, une information
A NEWS ITEM: une information (contexte journalistique)
A TREND : une tendance
A TOPICAL ISSUE: un sujet d'actualité
TO COVER AN EVENT: couvrir événement
MEDIA COVERAGE: la couverture médiatique
A LEADER /LEADING ARTICLE / EDITORIAL: un éditorial
A COLUMN: une rubrique / une chronique
A SEASONAL FEATURE: un marronier
AN AGONY COLU	: le courrier du coeur
FILLERS / SMALL TOWN NEWS: la rubrique des chiens écrasés
A FEATURE: un article de fond
A SURVEY: enquête 
A POLL : un sondage
A REPORT: un compte-rendu, un reportage
TO CHARGE FOR CONTENT : faire payer pour l’accès au contenu
A REVENUE STREAM : une source de revenus
A PAYWALLED NEWSPAPER : site internet d'informations payant
TO INVESTIGATE STH: enquêter sur qch
TO DIG STH UP/ TO UNEARTH: dénicher, mettre au jour
TO MAKE INFORMATION AVAILABLE TO THE PUBLIC:  rendre une info publique
TO SENSITISE PUBLIC OPINION: sensibiliser l'opinion
TO EXPOSE: dénoncer, discréditer
MUCKRAKING: type de journalisme qui vise à révéler des scandales impliquants des dirigeants politiques, acteurs économiques etc. .. pour les porter à l’attention du public. 
TO CHECK ONE'S SOURCEs: vérifier ses sources
TO LEAK STH: divulguer (—›A LEAK = une fuite)
TO HUSH STH UP: étouffer qch
TO PAY SB HUSH MONEY : acheter le silence de qn
TO BLOW THE WHISTLE ON SB/STH : donner l'alerte sur qch
A WHISTLEBLOWER : un lanceur d’alerte
THE FREEDOM OF THE PRESs : la liberté de la presse
FACT-CHECKING: vérification des sources / des faits
TO MISINFORM: donner des informations erronées
TO CENSOR SB/STH: censurer qn/QGh 
TO SLANDER: Calomnier
BIASED / PREJUDICED: partisan/tendancieux (UNBIASED =impartial)
TO SLANT INFORMATION: informer d'une façon tendancieuse 
TO SENSATIONALISE NEws: rechercher le sensationnel 
SCAREMONGERING: l'alarmisme
CLICK-BAIT: pièges à clics
TO HIT THE HEADLINES: faire les gros titres
MEDIA HYPE: battage médiatique
INFORMATION GLUT /OVERLOAD (// DATA SMOG): saturation del'info°
JOURNALESE: le jargon journalistique
RELIABLE: fiable (UNRELIABLE= sujet à caution)
NEWSWORTHY: qui a un intérêt médiatique / mérite d'être ds l'actualité
APPROPRIATE: approprié (INAPPROPRIATE= déplacé)
ACCURATE: exact/précis (INACCURATE= inexact) 
TO URGE SB TO DO STH: exhorter à
RÉGULATIONS: la réglementation
TO ENFORCE DATA PROTECTION LEGISLATION: faire appliquer des lois sur l’informatique et les libertés
TO WATCH TELEVISION/Tv: regarder la télévision	
To SAFEGUARD PRIVACY FROM COMMERCIAL ABUSE: protéger la vie privée des abus commerciaux
LINEAR PROGRAMMING: télévision linéaire	
CATCH-UP TV / PAY-PER-VIEW Tv: le replay /TV à la demande	
INTELLECTUAL PROPERTY: la propriété intellectuelle 
A TV PROGRAMME (UK) / PROGRAM (US): une émission de télé	
ILLEGAL DOWNLOADING: téléchargements illégaux 
TO BROADCAST (BROADCAST/BROADCAST) : diflîiser	
COPYRIGHT VIOLATION: violations des droits d’auteur
STREAMING: diffûsion en continu, en flux	
TO INFRINGE ON SB’S RIGHTS: porter atteinte aux droits de qn
BINGE-WATCHING: visionnage marathon, à la chaîne	
TO TRACK SB DOwN: retrouver, localiser qn 
PRIME TIME: les heures de grande écoute	
TO PROSECUTE SB: poursuivre qu en justice
THE NEWs: les actualités	
TO FINE SB: condamner qn à une amende
A NEWSREADER: présentateur (du JT)
A HOST / AN ANCHORMAN: présentateur / animateur TV
A TV SERIES / SOAP OPERA: une série télé 
A (TV) COMMERCiAL: une pub (télé)
A TV CHANNEL: chaîne de télé 
A TV VIEWER: un téléspectateur
THE AUDIENCE: le publie (—›AUDIENCE RATINGS = l'audimat)
A MOBILE / A CELL PHONE: un téléphone portable 
TO PLACE / MAKE A CALL: passer un coup de fil 
TO RETURN A CALL: rappeler qn
TO GET DISTRACTED: être dérangé/déconcentré
A HACKER: un pirate ( HACKING, PIRAcY= le piratage)
TO HACK INTO A COMPUTER: pirater un système informatique
TO STEAL PASSWORos: voler des mots de passe
TO BE STRUCK BY A VIRUs: être victime d’un virus
A RANSOMEWARE ATTACK: attaque par rançongiciel
CYBER-BULLYING: la cyberintimidation
CYBER-LYNCHING: lynchage en ligne
CYBERTHEFT: le vol de données électroniques
CYBERCRIME: la cybercriminalité 
CYBERWARFARE: la cyberguerre (!= cYBERDEFENSE)
CONVENIENT: pratique (!= iNCONVENIENT = gênant)	
ELECTRONIC SURVEILLANCE: surveillance électronique
TO DISTURB: déranger (DISTURBANCE = dérangement)	
INVASION OF PRIVACY: atteinte à la vie privée
INTRUSIVE: importun / gênant / intiusif (TO INTRUDE ON =s’immiscer ds)	
TO HARVEST INFORMATION (FROM A FACEBOOK ACCOUNT): récolter des info° (d’un compte Facebook)
TO DISRUPT: perturber ( DISRUPTIVE = perturbateur)
PHONE HACKING : piratage de téléphone/écoutes téléphoniques	
TO SPY ON SB / TO SNOOP ON sB: espionner qn
CCTV (CLOSED CIRCUIT TELEVISION): caméras de vidéosurveillance
AN ISP (INTERNET SERVICE PROVIDER): un fournisseur d'accès
A SEARCH ENGINE, A WEB BROWSER: moteur de recherche, navigateur
A NETSURFER: un internaute
TO GO ONLINE /BROWSE THE NET: aller sur le net
TO LOG ONTO A WEBSITE: se connecter à un site internet
TO GOOGLE SB / STH: rechercher des informations avec Google
TO DISCLOSE PERSONAL DATA: dévoiler des informations personnelles
ACHAT ROOM: un forum de discussion
A SOCIAL NETWORK(-ING SITE): un réseau social 
A TROLL FARM(/FACTORY): une  usine à trolls 
A DATABASE: une base de données
DIGITAL NATIVES: jeunes générations nées à 1’ère numérique
TO STORE DATA: conserver/stocker des info°s
SATNAV (SATELLITE NAVIGATION SYSTEM), A GPS DEVICE: un GPS
TO CYBERSHOP / SHOP ONLINE: faire ses courses en ligne
TO DELIVER TARGETED ADs: envoyer des publicités ciblées
TO ADJUST PRIVACY SETTINGS: régler les paramitfes de confidentialité
NO NEWS IS GOOD NEwS: pas de nouvelles, bonnes nouvelles
TO GO VIRAL: faire le buzz
TO SPREAD LIKE WILDFIRE: se répandre comme une traînée de poudre
