THE ENVIRONMENT: l’environnement
rien NATURE: la nature 
TO SPOIL!= UNSPOILT: Salir, gâcher!= intact
NATURAL RESOURCES: les ressources naturelles
TO JEOPARDISE: mettre en péril
TO WASTE / TO SQUANDER : gaspiller
TO DAMAGE STH: endommager (les dégâts = damage (au sing))
TO MISUSE : faire mauvais usage (de)
A(N ENDANGERED) SPECIES : une espèce (en voie de disparition) 
THE DEPLETION OF THE OZONE LAYER : diminution de la couche d’ozone 
AIR POLLUTION : pollution atmosphérique
GREENHOUSE GASES: les gaz à effet de serre
THE GREENHOUSE EFFECT: l’effet de serre
CARBON DIOXYDE ( CO2): le dioxyde de carbone
STIFLING: étouffant (air)
UNBREATHABLE: irrespirable (air)
TO CHOKE: (s’)étouffer
TO FIGHT/GASP FOR BREATH: avoir du mal à respire
GLOBAL wARMING: le réchauffement de la planète
TO ALTER WEATHER PATTERNS: modifier les modèles climatiques
MAN-MADE GLOBAL WARMING: réchauffement climatique causé par l’homme
CLIMATE CHANGE SCEPTICS: désigne ceux qui remettent en cause l'existence
du changement climatique
CLIMATE CHANGE DENIERS: désigne ceux qui contestent l'existence du changement climatique
AN ENVIRONMENTAL POLICY: une politique environnementale 
A CLIMATE CHANGE POLICY: politique en matière de changement climatique
THE LEGAL FRAMEWORK: le cadre légal / juridique
AN ENVIRONMENTAL FOOTPRINT: l’empreinte écologique
A CARBON FOOTPRINT: l’empreinte carbone
CARBON OFFSETTING: compensation des émissions de CO2
A CARBON TAX: une taxe carbone
CAP-AND-TRADE: plafonner et échanger (les quotas d’émissions)
TO CRACK DOWN ON POLLUTERs: sévir contre les pollueurs
THE POLLUTER-PAYER PRINCIPLE: principe du pollueur payeur
TO INTRODUCE/IMPOSE STANDARDS: créer/imposer des normes
ENVIRONMENTAL REGULATIONS : Règlementations environnementales
TO MEET ENVIRONMENTAL TARGETS: atteindre des objectifs environnementaux
GLOBAL DAMAGE: dégâts à 1’échelle mondiale
ACID RAIN: les pluies acides
SOIL EROSION: 1’érosion (des sols)
TO EXHAUST, TO DEPLETE: épuiser
TO DWINDLE: diminuer en nombre
TO CONTAMINATE, TO POISON: contaminer, empoisonner
A POLLUTANT: un polluant 
POLLUTANT-FREE: sans agent polluant
NOXIOUS: nocif / HARMFuL: nocif, nuisible 
HARMLESS :inoffensif
CARCINOGENIC/ CANCER-CAUSING: cancérigène
WATER POLLUTION: la pollution des eaux
GROUND WATER: la nappe phréatique
DRINKING WATER: eau potable 
TAP WATER: eau du robinet
TO CONTAMINATE (TO DECONTAMINATE): contaminer
DEFORESTATION: déforestation
THE LOGGING INDUSTRY: 1 industrie du bois
TO FELL / CUT DOWN TREES: abattre des arbres
TIMBER: bois de construction
LAND-CLEARING: le défrichage
HABITAT LOSS: la disparition des habitats naturels
INDUSTRIAL FARMING: l’élevage intensif
RUBBISH COLLECTING : le ramassage des déchets
HAZARDOUS wASTE: les déchets dangereux
HOUSEHOLD WASTE: déchets ménagers
INDUSTRIAL WAST: déchets industriels 
RADIOACTIVE DISCHARGEs: rejets radioactifs 
RADIOACTIVE FALLOUT: retombées radioactives 
TO LEAK: fuÎr
AN OIL SPILL / A BLACK TIDE: une marée noire 
TO FLUSH / TO SWILL TANKs: dégazer
TO DUMP: déverser (illégalement)
A JUNKYARD / A LANDFILL / A RUBBISH DUMP : décharge publique
TO DISPOSE OF STH: se débarrasser de qch
RECYCLING COSTS: les coûts du recyclage
NIMBYISM: basé sur l'acronyme Not In My Back Yard ('Pas de ça chez moi'. Décrit les oppositions locales à l'implantation de nouveaux équipements malgré une adhésion de principe au projet.)
NATURAL HAZARDS: risques naturels
AN ENVIRONMENTAL DISASTER: une catastrophe écologique
A RISE IN SEA LEVEL : une élévation du niveau de la mer
THE SCOPE / EXTENT OF A DISASTER: l’ampleur d’une catastrophe
A DISASTER VICTIM: un sinistré
A LANDSLIDE: un glissement de terrain
AN EARTHQUAKE: un tremblement de terre
A TORNADO: une tornade	- EcO-AwAnc: conscient(e) des enjeux écologiques
A HURRICANE: un ouragan	-A cAMPAIGN: une campagne
A FLOOD: une inondation (—rTO FLOOD : inonder)	
TO SENSITISE: sensibiliser (le public)
A TIDAL WAVE: un raz-de-marée	
AN AWAKENING TO STH: une prise de conscience concernant qch
A DROUGHT: la sécheresse 
TO DRY UP: se dessécher	
A TREE-HUGGER: un écolo fanatique (péjoratif)
FREAK/EXTREME WEATHER EVENT : phénomène climatique anormal/extrême	* GREENWASHING: l’écoblanchiment     (vernis écolo)
A FOOD SHORTAGE: une pénurie alimentaire
MALNOURISHED: sous-alimenté, malnutri
STARVATION: la famine
SUSTAINABLE DEVELOPMENT: le développement durable 
ECOLOGY / ENVIRONMENTALISM: l’écologie	
TO REPROCESs: retraiter
AN ENVIRONMENTALIST / A CONSERVATIONIsT: un écologiste	
TO CLEAN UP: assainir
THE GREENs: les verts	
WASTE DISPOSAL: traitement des déchets
A CAMPAIGNER: un militant	
TO MEET STANDARDs: répondre à des normes
A GREEN LAw: une loi “écologique”	
AN INCENTIVE: une mesure incitative (J A DETERRENT)
AN AWARENESS CAMPAIGN: campagne de sensibilisation	
TO WATCH: surveiller
TO MAKE THE PUBLIC AWARE (OF STH): faire prendre conscience de	
TO BOYCOTT: boycotter
TO BECOME AwARE OF: prendre conscience de	
TO CAMPAIGN AGAINST STH: faire campagne contre qch
ENVIRONMENTALLY-FRlENDLY /ECO- : sans danger pour l’env.	
TO ENFORCE THE LAW: faire respecter la loi
ENERGY CONSERVATIoN : les économies d’énergie
CLEAN ENERGY: énergie propre, non polluante
THE PRECAUTIONARY PRINCIPLE : Ie principe de precaution
