POLITICS: la politique (≠ A POLITICIAN =  un homme politique)
A POLITICAL PARTY : un parti politique
A POLICY-MAKER / A LAW-MAKER: un responsable politique
DOMESTIC POLICY: politique intérieure
FOREIGN POLICY: politique étrangère
A FLAGSHIP POLICY: une politique phare
THE WEST/THE EAST : L'Occident/L'Orient
A HEAD OF STATE / HEAD OF GOVERNMENT: un chef d’Etat / de gvt 
A RIGHT-WING / LEFT-WING PARTY: (parti) de droite /de gauche 
A RIGHT-WINGER : de droite, un conservateur
A LEFT-WINGER : de gauche, libéral/personne de gauche
PROGRESSIVE/LIBERAL (US) : libéral (socialement)
THE POLITICAL SPECTRUM: l'échiquier politique
THE POLITICAL LANDSCAPE: le paysage politique
POLITICAL CLOUT : influence politique
A CONSERVATIVE : un conservateur
HARD-LINE (mi) : pur et dur, intransigeant, radical
A HARD-LINER : un jusqu'au-boutiste / irréductible
MIDDLE OF THE ROAD: centriste
OF ALL STRIPES: de tout bord /de toutes les allégeances politiques
TO RULE/LEAD/RUN A COUNTRY: diriger un pays
THE INCUMBENT PRESIDENT: le président en exercice 
A LAME-DUCK PRESIDENT: le président sortant
TO RUN FOR OFFICE: se présenter à des élections
FREE AND FAIR ELECTIONs : des élections libres et régulières
TO CALL FOR AN ELECTION/A REFERENDUM:demander une élection 
TO HOLD A REFERENDUM (ON): organiser un referendum (sur) 
DEVOLUTION: décentralisation
A GENERAL ELECTION (UK) : des élections législatives
A BY-ELECTION: des élections législatives partielles
A SNAP ELECTION: des élections anticipées
AN MP (Member of Parliament, UK) / A CONGRESSMAN (Member of House of Representatives, US) : un député
DICTATORSHIP: la dictature
A COUP : un coup d'Etat
TO TAKE/SEIZE POWER : s'emparer du pouvoir
TO RIG AN ELECTION: truquer une election
TO GO TO THE POLLS: aller aux urnes 
THE FRANCHISE: le droit de vote
TO DISENFRANCHISE: priver du droit de vote 
A VOTER // A CONSTITUENT [UK]: un électeur
A CONSTITUENCY [UK]: une circonscription
VOTER ID: carte d’électeur
A BALLOT BOX / BALLOT PAPER: une urne électorale / un bulletin de vote
TO CAST A BALLOT : voter
THE TURNOUT: la participation (// to east a ballot= to vote)
A STAY-AWAY VOTER : un abstentionniste
TO BACK / TO SUPPORT (A POLICY, SB): soutenir
AN APPROVAL / POPULARITY RATING: une côte de popularité 
TO ELECT SB: élire qn
A PRIMARY ELECTION [Usj: une primaire
THE REPUBLICAN / DEMOCRATIC NOMINEE: le candidat (officiel) du parti républicain / démocrate (dans une élection présidentielle) 
A/THE FRONT RUNNER: un/le favori
AN UNDERDOG/OUTSIDER: outsider / celui qui est donné perdant 
TO DROP OUT (OF THE RACE): se retirer (de la course)
A CAMPAIGNER: un militant/ candidat en campagne
CANVASSING: le démarchage électoral
A PLATFORM: un programme électoral (//MANIFESTO= syn. mais à l’écrit)
TO ENDORSE SB: apporter son soutien politique à qn
THE TICKET (US): liste électorale portant le nom du président et du vice-président
A BATTLEGROUND / SWING STATE: un Etat clef(dont le vote peut changerle cours d'une élection)
TO WIN AN ELECTION: remporter une élection
-A LANDSLIDE VICTORY: une victoire écrasante ‹// to win by a landslide)
-A CRUSHING DEFEAT: une défaite écrasante
TO COME INTO OFFICE / POWER: arriver au pouvoir
TO RESIGN FROM OFFICE / TO STEP DOWN: démissionner 
TO IMPEACH: destituer (// IMPEACHMENT (N))
TO MAKE (//GIVE, DELIVER) A SPEECH: faire un discours
A SPOKESPERSON ( MAN / -WOMAN): un porte-parole
TO SPEAK PLAINLY : parler franchement, en langage d'air
A STUMP SPEECH: un discours de campagne (formaté, répété...)
A POLITICAL OPPONENT: un opposant / adversaire politique
TO ACT AS A MOUTHPIECE FOR SB/STH : se faire le porte-voix de
TO SKEW SB'S OPINION: fausser/biaiser l'opinion de qn
TO DIVIDE AND CONQUER (// RULE): diviser pour mieux régner
A SPIN DOCTOR: un conseiller en communication
PR (PUBLIC RELATIONs): relations publiques
A FAKE NEWS MEDIA OUTLET: média colporteurs de fausses info°s
A BOGUS / FABRICATED HEADLINE: (gros) titre bidon / faux
BIASED / PARTISAN / ONE-SIDED: partial / partisan / tendancieux
FACT-FREE RETELLING OF EVENTS: narration d'événements sans aucun fond de vérité
TO BE OUT OF TOUCH (WITH REALIw): être déconnecté (des réalités)
TO ADVOCATE (FOR) STH: préconiser qch
TO HAVE A SAY IN STH: avoir son mot à dire sur qch
TO DRAW A/THE LINE (AT STH): fixer/poser une limité (à)
TO CROSS A LINE: aller trop loin/franchir une limite (ex éthique)
TO LOBBY FOR/AGAINST STH: faire pression pour /contre qch
A THINKTANK: un groupe de réélection (perform research&advocacy) 
TO SHORE UP SUPPORT FOR SB/STH: soutenir, consolider le soutien envers 
TO WAVER: hésiter, faiblir (soutien)
TO STRIKE A DEAL: passer un accord
TO LIVE UP TO SB’S EXPECTATIONs: être à la hauteur (des attentes) 
TO KEEP / BREAK ONE’S PROMISES (TO SB): tenir/ne pas tenir ses promesses (envers qn)
WISHFUL THINKING: un vœu pieux (J REALISTIC, FEASIBLE)
A PIPE DREAM: une chimère
A RECIPE FOR DISASTER: qch qui assure de courir à la catastrophe / mener droit au désastre
TO BE OUT OF SB’S HANDs: ne plus être du ressort de qn
TO CARRY OUT / FULFILL ONE’S DUTY: aGcomplir son devoir
TO DO ONE’S BIT: apporter sa contribution, jouer son rôle
TO FALL SHORT OF EXPECTATIONs: ne pas être à la hauteur desattentes
A MISDEMEANOUR: un écart de conduite
SELF-ENRICHMENT: 1 enrichissement personnel 
CRONYISM: copinage, népotisme
TO BRIBE: corrompre
(BRIBERY AND) CORRUPTION/SLEAZE: la corruption
TO GO UNPUNISHED (of a crime) :- rester impuni
TO TARNISH A RÉPUTATION: ternir une réputation
A STELLAR REPUTATIoN: une solide réputation (// IMPECCABLE)
IT'S A SLIPPERY SLOPE: c est un terrain glissant
TO STONEWALL: pratiquer la langue de bois
TO DODGE AN ISSUE: esquiver un problème/éluder une question
TO SWEEP STH UNDER THE CARPET: occulter / cacher qch
TO HOLD SB ACCOUNTABLE (FOR STH): tenir qn pour responsable de
TO MEND ONE'S WAYs: se racheter une conduit
TO ATONE FOR STH (past sins): expire une faute (d’anciens péchés)
TO EAT HUMBLE PIE [US] : faire amende honorable/reconnaître son erreur
THERE’S ROOM FOR IMPROVEMENT: (loc) se dit de qch de perfectible
TO BE AT THE TOP OF THE AGENDA: ê en tête des préoccupations
TO BE OFF THE AGENDA: ne pas/plus être à 1’ordre du jour 
TO CARRY OUT REFORMs: mettre en place des réformes
TO ISSUE GUIDELINES (ON STH): émettre des directives sur qch 
TO INTRODUCE A BILL: présenter un projet de loi
TO VOTE A LAW (ON STH): voter, adopter une loi (sur) 
A RESHUFFLE (< A SHAKE-UP): un remaniement
A LEGAL LOOPHOLE: un vide juridique / une échappatoire
TO FIND A WORKAROUND : trouver un moyen de contourner (une loi, obligation, règle, obstacle)
TO FLY IN THE FACE OF STH: aller à l’encontre de, faire fi de, contredire
UNDER BRITISH LAW: Selon le droit britannique....
TO PUT STH ON THE BACK BURNER: reléguer qch au second plan (remettre à plus tard)
TO BE WILLING TO DO STH: être prêt à / disposé à faire qch
TO GIVE SB THE GO-AHEAD: donner le feu vert à qn
TO IMPLEMENT A LAW (//to put a law into effect) :  mettre en application (//oeuvre)
TO ENFORCE: appliquer, faire respecter
TO COME INTO EFFEcT: entrer en vigueur
TO REPEAL A LAW: abroger une loi
TO MAKE A DIFFERENCE: changer les choses
TO TURN A SITUATION AROUND: changer/redresser une situation
A LEGACY: contribution, héritage
A TERRORIST ATTACK: une attaque terroriste 
THE THREAT LEVEL: le niveau d’alerte
A LONE-WOLF (TERRORIST) ATTACK: un acte terroriste isolé
9/11 ('NINE/ELEVEN'): le 11 septembre 2001
7/7: les attentats de Londres du 7 juillet 2005
THE 6th OF JANUARY ATTACK : l'attaque du Capitole du 6 janvier 2021
TO STORM A BUILDING: prendre un bâtiment d’assaut
THE AFTERMATH: les suites / conséquences (négatives) de qch
FANATICISM: le fanatisme, 
FUNDAMENTALISM: l'intégrisme 
A ROGUE STATE: un Etat-voyou
THE NUCLEAR DETERRENT: la force de dissuasion nucléaire
TO CONDONE TERRORISM: cautionner le terrorisme
TO RESORT TO STH: avoir recours à qqch 
SCARE TACTICs: le terrorisme psychologique 
INDISCRIMINATE VIOLENCE: violence aveugle
HOME-GROWN TERRORISM : terrorisme de l'intérieur (régional/national)
TO THREATEN: menacer
TO CARRY OUT A THREAT: mettre une menace à exécution
TO GIVE IN TO / TO YIELD TO A THREAT: céder à la menace
A CASUALTY: une victime
TO BE INJURED/HURT: être blessé
TO BE MAIMED: être mutilé
A SLAUGHTER/MASSACRE: un massacre (//A BLOODSHED / CARNAGE)
TO THWART (//TO FOIL): déjouer un attentat terroriste
A KNEE-JERK RESPONsE: une réaction impulsive /irréfléchie
HAWKISH / WAR-HUNGR : belliqueux
GUN-BOAT DIPLOMACY: la diplomatie de la canonnière
WEDGE POLITICS: la politique de la division
TO PAY LIPSERVICE TO: faire un effet d’annonce /paroles en l’air 
TO DECLARE A STATE OF EMERGENCv: déclarer l'état d’urgence 
TO EXTEND THE STATE OF EMERGENCY: prolonger l'état d'urgence 
TO FIGHT TERRORISM: combattre le terrorisme
THE FIGHT AGAINST TERRORISM: le combat contre le terrorisme 
TO WAGE WAR AGAINST: faire la guerre contre
TO BE SHELL-SHOCKED: être traumatisé par la guerre
PTSD (POST-TRAUMATIC STRESS DISORDER): SSPT
AN INTELLIGENCE AGENCY: une agence de renseignement 
ELECTRONIC SURVEILLANCE: la surveillance électronique 
TO TIGHTEN SECURITY: renforcer la sécurité
TO TRACK SB'S ONLINE ACTIVITY: suivre qn à la trace sur internet 
TO ERODE INDIVIDUAL FREEDOMS: éroder les libertés individuelles 
TO RESPECT CITIZENS’ RIGHTs: respecter les droits des citoyens 
A WATCHDOG GROUP: un organisme de contrôle/ vigilance
A STALEMATE: une impasse (to reach # to break)
A TRADE-OFF: un compromis
