AN IMMIGRATION POLICY: une politique de 1’immigration 
SELECTIVE / CONTROLLED IMMIGRATION: immigration Ghoisie 
TO SCREEN IMMIGRANTS: filtrer les immigrants
THE IMMIGRATION BACKLOG: le retard dans l’examen des demandes d’immigration
MIGRATION FLOWS: flux migratoires
A FOREIGNER: un étranger ( ! STRANGER = un étranger (=inconnu))
AN ILLEGAL MMIGRANT: un clandestin
AN ASYLUM SEEKER: un demandeur d'asile 
A HOST COUNTRY: un pays d’accueil
A WAVE OF IMMIGRANTS: une vague d'immigrants 
AN EXODUS : un exode
LARGE-SCALE / MASS IMMIGRATION: immigration de masse 
AN INFLUX OF IMMIGRANTS: un afflux d’immigrants
TO FLEE (FLED, FLED): fuir
ETHNIC CLEANSING: la purification ethnique 
A GENOCIDE : un génocide
HUMAN TRAFFICKING: trafic des êtres humains
A SMUGGLER: un contre-bandier / passeur
PEOPLE-SMUGGLERS: passeurs d'immigrants clandestins 
TO APPLY FOR CITIZENSHIP: demander la nationalité
TO GRANT CITIZENSHIP: accorder la nationalité
TO QUALIFY AS : remplir les conditions requises pour obtenir le statut de... 
TO BECOME FULLY INTEGRATED INTO: s’intégrer parfaitement dans 
A NEWCOMER: un nouvel arrivant
TO START FROM SCRATCH: partir de rien
A NATIVE :  un autochtone (//NATIVE /HOME COUNTRY = pays natal/ d'origine)
A TENSE SITUATION: une situation tendue
TO SPARK / FUEL TENSIONS: déclencher / alimenter les tensions 
ANTI-MMIGRANT FEELINGs: sentiments xénophobes
TO KEEP IMMIGRANTS OUT: empêcher les immigrants d'entrer
TO INTRODUCE/ROLL BACK IMMIGRATION CAPS: mettre en place/baisser les quotas d’immigration
TO CROSS THE BORDER: traverser la frontière
BORDER PATROLS: patrouilles de police frontalières
TO TAKE JOBS AWAY FROM THE NATIVES: prendre les emplois des nationaux
A SCAPEGOAT : un bouc émissaire 
TO SCAPEGOAT Sb: faire porter le chapeau à
RACIAL/ SEX DISCRIMINATION: discrimination raciale, sexuelle 
THE POLITICAL DIVIDE: la fracture politique
TO BE DISCRIMINATED AGAINST: être victime de discrimination 
TO VICTIMIZE SB: persécuter qn
NARROW-MINDED /PREJUDICED: borne, à l’esprit étroit 
A PREJUDICE:un préjugé
CHAUVINISTIC: H phallocrate, machiste 2) chauvin
HOMOPHOBIC: homophobe
TO FOSTER, FUEL HATRED: favoriser / attiser la haine
A RACIAL ATTACK: une agression raciste
GENDER STEREOTYPES: les stereotypes lies au sexe 
SEXUAL / MORAL HARASSMENT: harcèlement 
MAINSTREAM CULTURE: culture dominante
TO BRING STH INTO THE MAINSTREAM/TO MAINSTREAM STH: faire rentrer dans la norme
SECOND-CLASS CITIZENS: des citoyens de seconde zone 
A TWO-TIER SOCIETY: société à deux vitesses
THE GAP BETWEEN THE HAVES AND THE HAVE-NOTS. fracture sociale
THE DISTRIBUTION OF WEALTH: le partage des richesses 
THE SOCIAL LADDER: 1 ascenceur social
THE LOWER RUNGS OF THE SOCIAL LADDER: bas de l’échelle sociale
A LOW INCOME HOUSEHOLD: ménage à revenus modestes
THE DESTITUTE: les plus démunis (// (N) DESTITUTION )
THE CIVIL RIGHTS MOVEMENT: le mvt des droits de l’homme
AFFIRMATIVE ACTION: mesures d'embauche anti-discriminatoires
COLOUR-BLIND LAWS: des lois sans discrimination raciale
TO REDRESS IMBALANCES: corriger les déséquilibres 
REGARDLESS OF RACE: quelle que soit la race
TO BE ON AN EQUAL FOOTING WITH: être sur un même pied d’égalité q
TO LEVEL THE PLAYING FIELD : rendre plus équitable, favoriser l’égalité des chances
TO STAND A FIGHTING CHANCE: avoir une réelle chance de
NOT TO STAND A CHANCE: n’avoir aucune chance de
DISCONTENT: le mécontentement
TO TAKE TO THE STREETS: descendre dans la rue
UNREST / TURMOIL: trouble, agitation
A PROTEST < A RIOT (TO BREAK OUT): une manifestation < émeute (éclater)
TO TRIGGER STH: déclencher, causer qch
TO TAKE DRUGs: se droguer (//A DRUG-ADDICT/ USER = un drogue)
TO BE HOOKED ON: être accroc à
DRUG-RELATED CRIMES: crimes lies à la drogue
DRUG-TRAFFICKING: le trafic de drogues 
BINGE DRINKING: alcolisation express
ALCOHOL / DRINK / BOOZE (COLL): la boisson, l’alcool 
TO GET DRUNK: se soûler
LAW ENFORCEMENT: le maintien de l’ordre
 TO ENFORCE THE LAW: faire respecter la loi
TO INVESTIGATE A CRIME: enquêter sur un délit
TO PATROL SENSITIVE SUBURBS: patrouiller les quartiers sensibles 
TO PREVENT (CRIME): empêcher, faire de la prevention contre 
TO CRACK / CLAMP DOWN ON STH: sévir contre qch
TO TACKLE ANTI-SOCIAL BEHAVIOUR: s’attaquer aux comportements antisociaux
TO ABIDE BY THE LAW: respecter la loi
TO PLAY BY THE RULES: respecter les règles du jeu
TO DO STH BY THE BOOK: faire qch en appliquant les règles à la lettre
TO BREAK THE LAW: enfreindre la loi 
AN OFFENCE: un délit
AN OFFENDER / A DELINQUENT: un délinquant 
A REOFFENDER : récidiviste
TO RE-OFFEND, TO REPEAT AN OFFENCE: récidiver
TO COMMIT A CRIME: commettre un crime
TO HAVE A CRIMINAL RECORD: avoir un casier judiciaire (// RAP SHEET)
TO ATTACK, TO ASSAULT, TO MUG: attaquer, agresser
A THIEF (PL THIEVES) / A ROBBER: un voleur
TO ROB SB OF: dépouiller qn de qch 
TO STEAL STH FROM SB: voler qch à qn
PETTY CRIME: la petite criminalité
SHOPLIFTING: le vol à 1’étalage
WHITE-COLLAR CRIME: la criminalité en col blanc
A VOYEUR: un voyeur
RAPE: le viol (/ (A RAPIST  = un violeur)
A MURDERER: un meurtrier
TO ARREST SB: mettre en état d’arrestation
TO CHARGE SB (WITH): accuser / inculper qn (de)
TO SUE SB / TO TAKE SB TO COURT: poursuivre qn en justice
A LAWSUIT / A TRIAL: un procès, 
A LAWYER : un avocat
A DEFENDANT: un accuse
Ø PROOF / EVIDENCE: des preuves
TO BE FOUND GUILTY OF STH: être reconnu coupable de qch
TO BE PROVED INNOCENT: être innocenté
A MISCARRIAGE OF JUSTICE: une erreur judiciaire
TO TARNISH SB’S (STELLAR) REPUTATION: ternir une reputation (exemplaire)
TO RIGHT A WRONG: réparer une injustice
A COMMUNITY SENTENCE: une peine de travaux d’intérêt general 
AN ELECTRONIC TAG: un bracelet électronique
TO BE ON PROBATION/ PAROLE: liberté conditionnelle / surveillée 
TO SEND SB TO PRISON/  TO JAIL: mettre qq derrière les barreaux 
AN INMATE: un détenu
PRISON OVERCROWDING: la surpopulation carcérale
LIFE EMPRISONMENT: la prison à vie
THE DEATH PENALTY/ Ø CAPITAL PUNISHMENT: la peine capitale
TO BE ON DEATH ROW: être dans le couloir de la mort
AN ABOLITIONIST: partisan de l’abolition de la peine de mort

