To be bogged = mired : etre embourbe     
To make a change : changer
To be disengaged from : être déconnecté de                  
To make decisions : prendre des decisions                     
To make it to the polls : se rendre aux urnes
To break a promise : ne  pas tenir sa promesse                
To mislead : induire en erreur
To break rules : enfreindre des regles     
To press the flesh : prendre un bain de foule
To bypass : contourner, eviter   
To campaign : faire campagne             
To prevent sb from + V-ing : empecher
To carry out official duties : exercer des fonctions officielles                    
To prosecute : juger
prosecution : poursuites
To coax sb into + V-ing : embobiner      
To publicise : annoncer, divulguer
To deceive : tromper                     
To push into : faire basculer
To discharge the mandate : mener a bien le mandat   
To reshuffle : remanier
To return power to the hands of the people : redonner le pouvoir au peuple
To disregard : se desinteresser de
To elect : elire                         
To rig : truquer
rigging : fraude
To embezzle money : detourner de l'argent
To run a campaign : mener campagne
To fare :s'en sortir, se debrouiller      
To squander : dilapider
To flood the media : inonder les medias    
To subsidise : subventionner
To form one's own opinion : se faire sa propre opinion 
subsidies : subventions
To take part in = participate in : participer
To gauge : mesurer
To govern = rule = run : diriger         
To voice = express : exprimer
To grant != lift immunity : accorder !=   
To woo voters : courtiser les electeurs
To have a say : avoir son mot a dire      
Trust!= distrust : confiance !=  mefiance
To impede : entraver                    
Trustworthy!= untrustworthy : fiable 
To implement : mettre en oeuvre          
Turnout : participation (à un vote)
To lie : mentir
To lower the voting age : abaisser l’age du droit de vote
Fraudster = cheater = scammer = swindler : magouilleur
Absentee voters : abstentionnistes                             
Abuse of power : abus de pouvoir                               
Fray: bagarre
Accountable for : responsable de 
Government official : representant du gouvernement
Advisory : consultatif
Audience survey : sondage aupres du public 
Guilty : coupable
Autocracy : suprem political power concentrated in the hands of one person
Head of state : chef d'état
Home Office → Home Secretary : ministere de l'interieur  → ministre de l’intérieur
ballot vote/ballot box : urne de vote                         
Ignorant = unaware : ignorant
Bandwagon effect : effet de mode                                  
Indictable offence : acte criminel 
binding : contraignant                                          
Influenced by : influencé par
Bribe : pot-de-vin
bribery : corruption                         
Level playing field : égalité des chances 
By birthright : acquis la naissance                             
Liability : responsabilite
Campaigner : militant                                           
Membership subscription : adhesion des adherents
Chancellor of the Exchequer (UK) = Secretary of the Treasury (US): ministre des finances                    
Misdeed = wrongdoing : mefait                                                
Misuse : abus
Checks and balances : pouvoirs et contrepouvoirs                       
Moneyed interests : interets financiers 
Moot point : question controversée
Civil service :fonction publique                          
MP = member of parliament : député 
Civil servant : fonctionnaire                                         
Newsworthy : sensationnel
Constituents = voters : electeurs                                 
Open-ended = empty = blue-sky promises : des promesses en l’air 
Contentious = controversial : litigieux                         
Corporate donor : entreprise donatrice                          
Platform : programme electoral
Corrupt : corrompu                                              
Politics → policy → politicien : la politique → une politique →  homme politique
Criminal charges : accusations penales                           
Cronyism : copinage                                             
PM = Prime Minister : premier ministre
Crown prince : prince heritier                                  
Polling stations : urnes
Decision-making : prise de decisions                            
Protest vote : vote protestataire
Democracy : effective political power vested in the people      
Proxy vote : vote par procuration
to vote by proxy : voter par procuration
Deputy Prime Minister : vice Premier  ministre                           
Public scrutiny : vigilance publique 
Dictatorship : dictature                                        
Red tape : paperasserie
Disappointed with : deçu de                                    
Reliable != unreliable  :fiable 
Discontent = dissatisfaction = Disaffection : mecontentement            
Shadow cabinet : cabinet fantome                       
Shenanigans = wheeling and dealing : magouilles
Disenchanted : desenchante                                      
Disillusioned : desillusionne                                   
Slam duck : une formalite
Dissatisfied = displeased with : mecontent de                 
Sleaze = corruption : corruption                   
Smooth talker : beau parleur
Elected representative : un élu                                 
Strong view = firm opinion : opinion bien tranchée
Electoral roll : liste electorale                               
Empowerment : emancipation                                      
Survey = poil : sondage 
Figurehead : figure emblematique                                
Taxpayer : contribuable 
Foreign Secretary (UK)= Secretary of State (US): ministre des Affaires etrangeres                            
To abide by : respecter          
To abstain (from): s'abstenir de/abstention
Franchise : droit de vote                      
to enfranchise : donner le droit de vote
to disenfranchise : priver du droit de vote                        
To back-pedal : faire marche arriere 
To bankroll a party : financer un part 
To be an adult : etre majeur




