2-year technical degree : BTS 2-year
university degree : DEUG
Academic achievement = performance :réussite scolaire (2)
Achievement gap : écart de rendement
A-level : examen final du secondaire
Appraisal = assessment : évaluation (2)
Apprenticeship training : formation en
apprentissage Appropriate : adapté
At one’s own pace : à son rythme
Authoritative = authoritarian = strict :autoritaire (3)
Autonomous = self-reliant : autonome (2)
Bachelor’s degree : baccalauréat ou licence
Behavioural difficulty : problème de comportement 
Detrimental!= Beneficial : bénéfique  (2)
Bias = prejudice → to be prejudiced against  : préjugé  → être victime de préjugés
Career-focused degree programmes : diplômes professionnalisants
Charter school : école sous contrat
Classmate : camarade de classe
Co-educational : mixte
College = university : faculté (2)
Compulsory = obligatory = mandatory : obligatoire (3)
Course : cours
Crammed classrooms : salles de classe bondées
Curriculum : cursus, programme
Customised = personalised = bespoke : sur mesure (3)
Degree = qualification : diplôme (2)
Disadvantaged = underprivileged = needy = destitute : défavorisé (4)
Discrepant results : écarts de résultats
Disruption = disturbance!= disruptive : perturbation (2) != perturbateur (1)
Ineffective != Effective : efficace 
First-hand experience : expérience directe
For-credit course : cours ouvrant droit à des crédits
Grades = marks : notes (2)
Graduate (n) : un diplômé
Graduation rate : taux de réussite
Head start : avance, avantage
Higher education : études supérieures
High-income/low-income families : familles à hauts/bas revenus
Illiteracy : illettrisme
Inner cities = deprived communities = slum areas : quartiers défavorisés (3)
Innumeracy : incapacité à calculer
Interpersonal relationships : relations humaines
IT (information technology) skills : connaissances informatiques
Job-hopping : changement fréquent d’emploi
K -12 : the sum of primary and secondary education
Knowledge : connaissances
Feague table : tableau de classement
Fecture : cours magistral
Lifelong learning : apprentissage tout au long de la vie
Master’s degree : master
Median earnings : salaires moyens
Merit pay = performance- related pay : paye au mérite (2)
Minority student : étudiant issu des minorités
Mismatch = inadequacy : décalage (2)
Online learning = e-learning : apprentissage en ligne (2)
Opportunity areas : quartiers à revitaliser, prometteurs
Peer pressure : pression des camarades
PhD = doctorate : doctorat (2)
Priority Education Zone : ZEP
Private school : école privée
Racketeering : racket
Sandwich course : formation en alternance
Schedule : emploi du temps
School curriculum : programme scolaire
School refusal : phobie scolaire
Secondary education : enseignement en lycée
Self-taught : autodidacte
Separately != side-by-side = together : séparément (1) != ensemble (2)
Single-sex class : classe unisexe
Skills : compétences
Social divide : fracture sociale
Spirit-crushing : qui détruit le caractère
State school : école publique
Stereotypical : stéréotypé
Stressful : stressant
Teaching shortage : pénurie de professeurs
Technical college : lycée technique
Test score : résultat obtenu au test
The underclass : le quart-monde
To achieve : atteindre, réaliser, accomplir
To afford : avoir les moyens
To apply for a scholarship : demander une bourse
To attend a class ~ attend school : suivre un cours ~ suivre des cours
To be bullied : être brutalisé
To be left behind = to lag behind : être largué
To be like sheep : être un mouton
To be on an equal footing : être sur un pied d’égalité 
To bridge the gap : combler le fossé
To curtail : brimer, freiner
To customise = tailor : personnaliser (2)
To deserve = merit : mériter (2)
To discourage : décourager
To drop out of school : quitter l’école
To earn a living : gagner sa vie
To enroll : s’inscrire
To fail an exam!= pass an exam : échouer un examen!= réussir un examen
To fare : s’en sortir/fare poorly : avoir des résultats médiocres
To feel bored : s’ennuyer
To force-feed : gaver
To gain hands-on knowledge : acquérir des connaissances pratiques
To graduate : obtenir son diplôme
To have basic life skills : avoir une formation de base
To make the most of : profiter de
To move up the educational ladder : progresser dans l’enseignement supérieur
To prioritise : privilégier
To skip : sauter, sécher
To stifle = quell : étouffer (2)
To struggle to get by : peiner à s’en sortir
To take = sit an exam : passer un examen (2)
To take on debt : s’endetter
To take out a loan : faire un prêt
To teach, taught, taught : enseigner
To twiddle one’s thumbs : se tourner les pouces
To vie/compete with : rivaliser avec
Top-notch education : enseignement de première qualité
Training : formation
Tuition fees : frais de scolarité/ private
tuition : cours particulier
Under pressure : sous pression
Undergraduate : étudiant non diplômé
Unfit = inadequate = inadapted : inadapté (2)
Useful = worthwhile : utile (2)
Useless = meaningless : inutile (2)
Vocational college : lycée professionnel
